

|..@@@@.|
|.......|
|.......|
|.......|
+-------+


|...@@@@|
|.......|
|.......|
|.......|
+-------+


|...@@@@|
|.......|
|.......|
+-------+


|...@@@@|
|.......|
|.......|
+-------+


|...@@@@|
|.......|
+-------+


|...@@@@|
|.......|
+-------+


|...@@@@|
+-------+


|...@@@@|
+-------+


|...####|
+-------+
